8.ox
.....oo.
......oo
...o...o
o.....o.
.....o..
......o.
o......o
........
